af	Afrikaans	南非语
af-ZA	Afrikaans (South Africa)	南非语
ar	Arabic	阿拉伯语
ar-AE	Arabic (U.A.E.)	阿拉伯语(阿联酋)
ar-BH	Arabic (Bahrain)	阿拉伯语(巴林)
ar-DZ	Arabic (Algeria)	阿拉伯语(阿尔及利亚)
ar-EG	Arabic (Egypt)	阿拉伯语(埃及)
ar-IQ	Arabic (Iraq)	阿拉伯语(伊拉克)
ar-JO	Arabic (Jordan)	阿拉伯语(约旦)
ar-KW	Arabic (Kuwait)	阿拉伯语(科威特)
ar-LB	Arabic (Lebanon)	阿拉伯语(黎巴嫩)
ar-LY	Arabic (Libya)	阿拉伯语(利比亚)
ar-MA	Arabic (Morocco)	阿拉伯语(摩洛哥)
ar-OM	Arabic (Oman)	阿拉伯语(阿曼)
ar-QA	Arabic (Qatar)	阿拉伯语(卡塔尔)
ar-SA	Arabic (Saudi Arabia)	阿拉伯语(沙特阿拉伯)
ar-SY	Arabic (Syria)	阿拉伯语(叙利亚)
ar-TN	Arabic (Tunisia)	阿拉伯语(突尼斯)
ar-YE	Arabic (Yemen)	阿拉伯语(也门)
az	Azeri (Latin)	阿塞拜疆语
az-AZ	Azeri (Cyrillic) (Azerbaijan)	阿塞拜疆语(西里尔文)
be	Belarusian	比利时语
be-BY	Belarusian (Belarus)	比利时语
bg	Bulgarian	保加利亚语
bg-BG	Bulgarian (Bulgaria)	保加利亚语
bs-BA	Bosnian (Bosnia and Herzegovina)	波斯尼亚语(拉丁文，波斯尼亚和黑塞哥维那)
ca	Catalan	加泰隆语
ca-ES	Catalan (Spain)	加泰隆语
cs	Czech	捷克语
cs-CZ	Czech (Czech Republic)	捷克语
cy	Welsh	威尔士语
cy-GB	Welsh (United Kingdom)	威尔士语
da	Danish	丹麦语
da-DK	Danish (Denmark)	丹麦语
de	German	德语
de-AT	German (Austria)	德语(奥地利)
de-CH	German (Switzerland)	德语(瑞士)
de-DE	German (Germany)	德语(德国)
de-LI	German (Liechtenstein)	德语(列支敦士登)
de-LU	German (Luxembourg)	德语(卢森堡)
dv	Divehi	第维埃语
dv-MV	Divehi (Maldives)	第维埃语
el	Greek	希腊语
el-GR	Greek (Greece)	希腊语
en	English	英语
en-AU	English (Australia)	英语(澳大利亚)
en-BZ	English (Belize)	英语(伯利兹)
en-CA	English (Canada)	英语(加拿大)
en-CB	English (Caribbean)	英语(加勒比海)
en-GB	English (United Kingdom)	英语(英国)
en-IE	English (Ireland)	英语(爱尔兰)
en-IN	English (Indian)	英语(印度)
en-JM	English (Jamaica)	英语(牙买加)
en-NZ	English (New Zealand)	英语(新西兰)
en-PH	English (Republic of the Philippines)	英语(菲律宾)
en-TT	English (Trinidad and Tobago)	英语(特立尼达)
en-US	English (United States)	英语(美国)
en-ZA	English (South Africa)	英语(南非)
en-ZW	English (Zimbabwe)	英语(津巴布韦)
eo	Esperanto	世界语
es	Spanish	西班牙语
es-AR	Spanish (Argentina)	西班牙语(阿根廷)
es-BO	Spanish (Bolivia)	西班牙语(玻利维亚)
es-CL	Spanish (Chile)	西班牙语(智利)
es-CO	Spanish (Colombia)	西班牙语(哥伦比亚)
es-CR	Spanish (Costa Rica)	西班牙语(哥斯达黎加)
es-DO	Spanish (Dominican Republic)	西班牙语(多米尼加共和国)
es-EC	Spanish (Ecuador)	西班牙语(厄瓜多尔)
es-ES	Spanish (Spain)	西班牙语(国际)
es-GT	Spanish (Guatemala)	西班牙语(危地马拉)
es-HN	Spanish (Honduras)	西班牙语(洪都拉斯)
es-MX	Spanish (Mexico)	西班牙语(墨西哥)
es-NI	Spanish (Nicaragua)	西班牙语(尼加拉瓜)
es-PA	Spanish (Panama)	西班牙语(巴拿马)
es-PE	Spanish (Peru)	西班牙语(秘鲁)
es-PR	Spanish (Puerto Rico)	西班牙语(波多黎各(美))
es-PY	Spanish (Paraguay)	西班牙语(巴拉圭)
es-SV	Spanish (El Salvador)	西班牙语(萨尔瓦多)
es-UY	Spanish (Uruguay)	西班牙语(乌拉圭)
es-VE	Spanish (Venezuela)	西班牙语(委内瑞拉)
et	Estonian	爱沙尼亚语
et-EE	Estonian (Estonia)	爱沙尼亚语
eu	Basque	巴士克语
eu-ES	Basque (Spain)	巴士克语
fa	Farsi	法斯语
fa-IR	Farsi (Iran)	法斯语
fi	Finnish	芬兰语
fi-FI	Finnish (Finland)	芬兰语
fo	Faroese	法罗语
fo-FO	Faroese (Faroe Islands)	法罗语
fr	French	法语
fr-BE	French (Belgium)	法语(比利时)
fr-CA	French (Canada)	法语(加拿大)
fr-CH	French (Switzerland)	法语(瑞士)
fr-FR	French (France)	法语(法国)
fr-LU	French (Luxembourg)	法语(卢森堡)
fr-MC	French (Principality of Monaco)	法语(摩纳哥)
gl	Galician	加里西亚语
gl-ES	Galician (Spain)	加里西亚语
gu	Gujarati	古吉拉特语
gu-IN	Gujarati (India)	古吉拉特语
he	Hebrew	希伯来语
he-IL	Hebrew (Israel)	希伯来语
hi	Hindi	印地语
hi-IN	Hindi (India)	印地语
hr	Croatian	克罗地亚语
hr-BA	Croatian (Bosnia and Herzegovina)	克罗地亚语(波斯尼亚和黑塞哥维那)
hr-HR	Croatian (Croatia)	克罗地亚语
hu	Hungarian	匈牙利语
hu-HU	Hungarian (Hungary)	匈牙利语
hy	Armenian	亚美尼亚语
hy-AM	Armenian (Armenia)	亚美尼亚语
id	Indonesian	印度尼西亚语
id-ID	Indonesian (Indonesia)	印度尼西亚语
is	Icelandic	冰岛语
is-IS	Icelandic (Iceland)	冰岛语
it	Italian	意大利语
it-CH	Italian (Switzerland)	意大利语(瑞士)
it-IT	Italian (Italy)	意大利语(意大利)
ja	Japanese	日语
ja-JP	Japanese (Japan)	日语
ka	Georgian	格鲁吉亚语
ka-GE	Georgian (Georgia)	格鲁吉亚语
kk	Kazakh	哈萨克语
kk-KZ	Kazakh (Kazakhstan)	哈萨克语
kn	Kannada	卡纳拉语
kn-IN	Kannada (India)	卡纳拉语
ko	Korean	朝鲜语
ko-KR	Korean (Korea)	朝鲜语
kok	Konkani	孔卡尼语
kok-IN	Konkani (India)	孔卡尼语
ky	Kyrgyz	吉尔吉斯语
ky-KG	Kyrgyz (Kyrgyzstan)	吉尔吉斯语(西里尔文)
lt	Lithuanian	立陶宛语
lt-LT	Lithuanian (Lithuania)	立陶宛语
lv	Latvian	拉脱维亚语
lv-LV	Latvian (Latvia)	拉脱维亚语
mi	Maori	毛利语
mi-NZ	Maori (New Zealand)	毛利语
mk	FYRO Macedonian	马其顿语
mk-MK	FYRO Macedonian (Former Yugoslav Republic of Macedonia)	马其顿语(FYROM)
mn	Mongolian	蒙古语
mn-MN	Mongolian (Mongolia)	蒙古语(西里尔文)
mr	Marathi	马拉地语
mr-IN	Marathi (India)	马拉地语
ms	Malay	马来语
ms-BN	Malay (Brunei Darussalam)	马来语(文莱达鲁萨兰)
ms-MY	Malay (Malaysia)	马来语(马来西亚)
mt	Maltese	马耳他语
mt-MT	Maltese (Malta)	马耳他语
nb	Norwegian (Bokm?l)	挪威语(伯克梅尔)
nb-NO	Norwegian (Bokm?l) (Norway)	挪威语(伯克梅尔)(挪威)
nl	Dutch	荷兰语
nl-BE	Dutch (Belgium)	荷兰语(比利时)
nl-NL	Dutch (Netherlands)	荷兰语(荷兰)
nn-NO	Norwegian (Nynorsk) (Norway)	挪威语(尼诺斯克)(挪威)
ns	Northern Sotho	北梭托语
ns-ZA	Northern Sotho (South Africa)	北梭托语
pa	Punjabi	旁遮普语
pa-IN	Punjabi (India)	旁遮普语
pl	Polish	波兰语
pl-PL	Polish (Poland)	波兰语
pt	Portuguese	葡萄牙语
pt-BR	Portuguese (Brazil)	葡萄牙语(巴西)
pt-PT	Portuguese (Portugal)	葡萄牙语(葡萄牙)
qu	Quechua	克丘亚语
qu-BO	Quechua (Bolivia)	克丘亚语(玻利维亚)
qu-EC	Quechua (Ecuador)	克丘亚语(厄瓜多尔)
qu-PE	Quechua (Peru)	克丘亚语(秘鲁)
ro	Romanian	罗马尼亚语
ro-RO	Romanian (Romania)	罗马尼亚语
ru	Russian	俄语
ru-RU	Russian (Russia)	俄语
sa	Sanskrit	梵文
sa-IN	Sanskrit (India)	梵文
se	Sami (Northern)	北萨摩斯语
se-FI	Sami (Inari) (Finland)	伊那里萨摩斯语(芬兰)
se-NO	Sami (Southern) (Norway)	南萨摩斯语(挪威)
se-SE	Sami (Southern) (Sweden)	南萨摩斯语(瑞典)
sk	Slovak	斯洛伐克语
sk-SK	Slovak (Slovakia)	斯洛伐克语
sl	Slovenian	斯洛文尼亚语
sl-SI	Slovenian (Slovenia)	斯洛文尼亚语
sq	Albanian	阿尔巴尼亚语
sq-AL	Albanian (Albania)	阿尔巴尼亚语
sr-BA	Serbian (Cyrillic) (Bosnia and Herzegovina)	塞尔维亚语(西里尔文，波斯尼亚和黑塞哥维那)
sr-SP	Serbian (Cyrillic) (Serbia and Montenegro)	塞尔维亚(西里尔文)
sv	Swedish	瑞典语
sv-FI	Swedish (Finland)	瑞典语(芬兰)
sv-SE	Swedish (Sweden)	瑞典语
sw	Swahili	斯瓦希里语
sw-KE	Swahili (Kenya)	斯瓦希里语
syr	Syriac	叙利亚语
syr-SY	Syriac (Syria)	叙利亚语
ta	Tamil	泰米尔语
ta-IN	Tamil (India)	泰米尔语(印度)
ta-LK	Tamil (Sri Lankan)	泰米尔语(斯里兰卡)
te	Telugu	泰卢固语
te-IN	Telugu (India)	泰卢固语
th	Thai	泰语
th-TH	Thai (Thailand)	泰语
tl	Tagalog	塔加路语
tl-PH	Tagalog (Philippines)	塔加路语(菲律宾)
tn	Tswana	茨瓦纳语
tn-ZA	Tswana (South Africa)	茨瓦纳语
tr	Turkish	土耳其语
tr-TR	Turkish (Turkey)	土耳其语
ts	Tsonga	宗加语
tt	Tatar	鞑靼语
tt-RU	Tatar (Russia)	鞑靼语
uk	Ukrainian	乌克兰语
uk-UA	Ukrainian (Ukraine)	乌克兰语
ur	Urdu	乌都语
ur-PK	Urdu (Islamic Republic of Pakistan)	乌都语
uz	Uzbek (Latin)	乌兹别克语
uz-UZ	Uzbek (Cyrillic) (Uzbekistan)	乌兹别克语(西里尔文)
vi	Vietnamese	越南语
vi-VN	Vietnamese (Viet Nam)	越南语
xh	Xhosa	班图语
xh-ZA	Xhosa (South Africa)	班图语
zh	Chinese	中文
zh-CN	Chinese (Mainland)	中文(简体)
zh-HK	Chinese (Hong Kong)	中文(香港)
zh-MO	Chinese (Macau)	中文(澳门)
zh-SG	Chinese (Singapore)	中文(新加坡)
zh-TW	Chinese (Taiwan)	中文(繁体)
zu	Zulu	祖鲁语
zu-ZA	Zulu (South Africa)	祖鲁语